1111111111111111111111111111111111
100C00000000000C00000C0000000E0001
10101000110001000000C0001100000011
1011000100100111001110001000001011
1P101001111C0111001000001C00000001
10000C000C00000C0000C000C000000001
1111111111111111111111111111111111