1111111111111
1P00010000E01
10000100000E1
100C010000001
1111111111111